1111111111111111111111111
1000100001000000000000001
100100001010C0000E0000101
1P010100100000000000001E1
1111111111111111111111111

