11111111111111111111111
10000X000000C00000000E1
1P0C0000000000000C00001
11111111111111111111111
