111111
1000E1
1P0001
100001
100C01
111111
