111111111111111111111111
10C0C00C0C00011000000E01
10000000C000011000000E01
1000C00000C0000000000E01
1P000000C000011000000E01
111111111111111111111111
